2C-3D-D8-F4-36-99-EE-5C-48-66-53-7A-DD-78-B0-7D
78-05-A1-D8-B3-0A-20-FC-19-2C-3F-18-5E-D4-67-22
D9-78-34-23-F7-71-EF-07-C4-FF-7E-12-95-06-1E-59
BA-F4-FC-9B-87-11-E6-AF-B0-8D-75-28-2C-B9-B7-DC
F1-4A-69-6D-E4-16-3C-A8-9F-9C-62-E6-DB-57-2A-51
53-B2-BA-89-D5-88-5F-AB-D6-AB-1D-0C-D1-2C-27-7F
B7-91-C6-23-46-E1-7E-12-C9-E1-27-D8-ED-7A-3D-32
6C-EF-41-4E-98-93-7C-B5-E0-E5-04-19-8F-53-B5-31
7E-B1-70-16-04-CA-39-05-3C-4E-40-97-5A-B5-89-04
BE-88-2B-85-75-8F-16-51-77-A3-6A-5C-5F-35-24-6F
97-5E-20-8B-2A-07-FF-56-D8-26-32-32-C8-FB-BF-0D
01-69-E5-D6-B4-75-3F-3C-66-C6-AC-3D-3A-69-DE-4E
D0-87-90-04-08-A0-A3-B7-B3-C5-24-42-72-07-32-AD
9B-2B-8C-A6-0A-5B-54-89-06-C9-2B-70-66-31-06-4D
65-0E-D9-86-76-21-93-D3-5E-18-1E-94-AA-6F-FC-7F
56-BF-F8-F4-D3-3B-5B-BC-BD-3E-1A-A8-F5-63-8D-67
CD-75-CC-6C-C1-80-FA-0E-4F-E6-0B-11-DE-56-CC-0D
A2-F2-AC-B3-C1-FF-AB-04-90-57-23-C2-CF-38-96-AD
2D-71-38-77-62-B3-90-EC-7C-AC-A9-4A-4B-A4-2D-57
83-B6-46-4E-A6-F0-30-3D-1D-EB-0D-FF-5A-F3-42-DB
77-2F-76-7C-1B-26-D1-58-1C-09-60-23-CA-2F-B8-F0
B4-A8-E7-7C-37-DC-7F-61-0D-80-87-23-50-3B-0E-16
1C-5F-DF-76-53-21-24-6B-EB-50-54-EA-D6-07-21-A9
27-97-4D-C6-55-F5-43-0B-45-5C-5C-EB-2D-B0-F1-A2
74-D9-B3-DF-29-16-53-6E-B4-FE-8C-59-AF-61-80-74
F3-64-42-69-DF-32-7A-C5-51-5F-86-C3-F6-E5-28-6D
2B-3E-9D-9F-FB-FE-78-5F-83-A0-94-B1-67-F9-B5-34
6E-7D-88-30-83-5B-7E-4B-06-1C-9B-B5-69-50-0C-BA
D3-F2-C2-BD-9D-7F-64-DC-80-E0-C9-2F-DE-86-45-29
09-65-57-7A-F5-4B-16-CE-0C-18-CA-0A-64-99-2E-A7
B5-D9-69-B4-FF-33-92-4B-EB-5B-00-0E-B0-3F-CF-CB
74-E7-6F-D8-D4-61-B1-2B-B3-28-B1-BE-12-E0-7B-43
6C-D3-48-56-46-64-C0-31-F2-D3-60-B7-F2-CF-42-05
54-23-B0-D6-AA-6C-8A-DC-44-2D-47-61-37-B0-92-2B
72-94-6E-7B-24-C8-AB-0C-33-AA-D6-E9-C4-10-32-87
B3-88-64-53-5A-2B-2D-57-EA-83-22-8A-02-3F-06-37
90-E3-DC-E0-25-94-BD-29-F9-8D-F8-54-CD-EE-87-80
C7-23-A9-9F-1E-48-E8-EB-80-EE-D9-56-01-42-49-99
FB-4D-D9-0F-C3-6A-33-F9-6E-DC-FD-4C-18-A0-B8-9E
A6-3B-C4-24-B6-99-C5-E1-0E-6E-5C-33-26-3A-C6-64
44-17-6A-34-E5-87-4A-DC-84-64-3E-4D-35-2F-7A-49
1C-1F-B6-3C-43-10-6C-83-E1-15-7A-66-72-10-19-50
F4-1F-76-ED-6A-C2-17-3B-EF-AE-0A-C2-4D-1C-07-5F
2A-F3-C1-D6-02-1F-82-8B-6E-1D-9A-A2-17-D0-91-68
47-CC-6E-AD-AF-0A-C6-87-28-E6-99-74-5B-1B-18-D0
45-56-FE-03-AA-B1-21-CE-39-F7-15-EB-EA-6F-07-92
9F-80-6E-C7-97-9E-F5-3E-ED-5D-43-94-24-78-C9-88
83-A9-73-5D-54-67-D0-BC-AA-D7-1A-04-19-28-EC-B8
33-84-93-D3-F4-B6-47-4D-7C-66-B7-58-B9-3A-DB-E4
B9-7D-83-2A-92-20-83-65-19-B9-E3-A3-0C-BE-A5-90
61-CE-64-11-A5-5C-97-E4-CC-1D-88-5A-C7-98-E4-84
D2-EB-90-B0-18-F9-84-58-A8-94-ED-09-15-8C-A2-84
91-2D-51-23-67-83-EE-9C-D5-D4-43-43-B1-41-25-FB
96-74-52-AC-58-7C-AF-FF-B3-48-8F-10-C4-03-8E-F4
62-D9-92-18-3B-49-0A-AA-72-44-A7-82-AA-66-D6-97
13-2D-49-2C-0F-18-59-EF-73-70-69-9B-FB-E3-F0-34
A1-41-F4-25-FC-7D-D7-10-BF-B6-56-22-CF-35-F7-19
8E-AE-6D-6E-F7-97-0C-29-04-0B-D3-BD-1E-47-A7-2B
64-00-48-AC-91-CF-5D-BE-B4-94-CF-64-37-B0-8B-EF
5B-4C-7D-76-F5-A8-2B-11-BA-78-39-3D-6F-05-7C-F7
43-C5-57-3F-B9-1F-6E-5C-81-D3-A1-3D-49-E8-F3-EF
FC-9E-00-D3-7A-0F-AE-61-83-DE-B9-FC-47-34-2B-83
AA-4E-FC-72-33-21-53-EF-42-E9-4C-1C-43-FF-D0-E9
FC-25-D0-E9-81-AB-64-C7-5E-C1-2E-06-D5-4B-AB-67
C0-10-5C-63-78-0A-21-CA-0C-27-89-2F-0F-2A-2E-17
29-61-6A-3F-47-91-FB-7B-56-46-40-74-F1-B3-46-EF
37-05-85-53-7C-BA-3A-83-34-F9-CC-7E-DB-9E-2C-04
E7-0D-92-AA-94-C2-D4-9B-5C-01-54-69-4C-3B-F6-96
69-A5-B9-0C-3E-21-04-1C-CB-CA-28-60-94-35-C1-BA
AE-EE-2E-7B-CF-2B-56-4B-3B-A4-51-AA-F3-9F-63-D6
56-E8-1C-1D-49-32-5E-C7-5E-4E-D1-F5-3D-42-46-8F
68-60-8F-B4-E0-BD-2E-CC-A9-F0-34-41-5C-A3-5E-C8
6E-CD-55-79-F3-8E-45-79-1F-E0-60-91-E0-1E-C4-F5
9D-34-EB-CA-C0-A7-35-C0-81-BA-2D-BA-10-C2-42-3B
F7-3D-D9-21-B0-2B-A8-97-EB-6A-8A-02-11-BB-83-1A
2E-5A-6D-47-9B-50-BF-62-3E-18-7F-C7-7A-91-93-43
A7-7E-D6-1C-4D-D6-91-D9-12-45-F9-E3-6F-91-DE-D0
99-79-15-8B-70-16-B5-81-76-4B-3E-15-53-A4-55-F7
C9-9E-81-23-A5-3C-10-31-5E-4C-48-4F-DF-03-DB-79
D3-B2-5E-4A-BF-D3-9A-C6-EC-9E-2B-97-BA-DF-B3-7F
A4-B9-79-F8-BA-17-95-19-16-DC-FC-62-E5-0A-1E-AC
20-EB-87-CA-C1-B9-84-E6-6A-76-75-5D-6D-85-75-0F
E8-11-A3-8B-AB-76-99-7F-A8-9D-AC-70-ED-97-0A-92
90-4B-83-9D-32-FC-73-2E-03-45-A6-6E-74-97-91-99
B3-FC-6B-62-1F-F3-27-4B-B3-31-11-59-27-3E-C6-56
C0-D3-8A-FB-2F-20-55-41-F3-65-F0-B7-01-B7-54-78
1F-37-22-5C-72-13-56-68-83-75-E1-C6-A7-31-0B-FA
C5-EF-F6-60-55-91-63-1B-C3-80-76-FD-64-21-F6-41
F8-60-DF-D7-3D-2B-5B-B8-5A-01-C0-96-A5-2E-A2-5A
C4-23-AB-3F-33-3A-9A-91-63-2E-4D-4B-3B-3D-41-23
F1-09-2B-20-D3-B2-DB-4F-7C-AF-D2-3B-93-1C-00-0B
A6-DE-00-16-8A-75-3C-F3-C7-A8-FC-DA-E4-24-8E-C5
A4-7F-21-17-24-D1-60-C6-20-78-2B-9E-15-7B-7F-26
1A-1E-60-DF-D9-C8-4B-4C-FE-89-07-6C-30-5C-74-79
FE-5E-FE-7A-11-8D-9B-2F-7C-A4-00-AB-15-BA-A1-FE
55-98-59-C7-A5-11-4A-9A-2E-48-DB-21-9B-50-FE-86
6F-12-41-17-81-D3-34-1C-6D-56-7D-D9-F4-00-E1-C8
51-53-4C-65-BA-CE-E3-D0-DB-55-5B-E8-F0-93-44-46
B7-A8-29-9E-D5-FC-69-89-AA-6F-D3-F8-75-0D-D7-56
E8-30-2C-62-66-08-9E-9A-60-5F-FB-F0-1F-4C-7B-43
19-5C-60-3F-7F-5F-15-47-6C-BB-A9-19-BF-DB-11-EE
5B-73-E6-D5-CD-9D-B0-B1-D6-F5-27-01-35-28-FE-3A
E4-79-B8-10-FA-7B-A8-06-37-6F-30-00-98-9B-F8-02
93-91-8A-F1-3F-C8-29-50-A6-ED-97-86-C9-7D-00-19
AD-B0-DC-DA-F8-02-D2-E4-81-1A-5F-70-11-38-02-CB
F2-FC-FE-C3-C0-E5-50-D7-99-F3-81-43-41-CC-B9-6E
8F-68-94-B7-B2-04-6C-30-C0-56-44-BC-8D-F3-30-03
BC-B5-F2-C4-BF-B1-45-28-23-76-B0-28-67-E1-82-1C
1E-47-BA-BE-5D-58-C6-E5-2F-AE-97-93-07-44-81-8A
BC-2A-81-6E-36-FF-DE-6F-2B-37-A2-11-97-28-9C-B0
63-3F-2A-8A-E8-4E-FD-A1-10-77-E2-2A-C6-FE-DD-B6
30-6F-7F-D7-C9-B5-F4-55-CB-CA-12-57-94-C3-F5-BF
0B-E7-ED-4F-9F-EA-EC-06-C1-49-F1-DC-EA-4A-A9-BE
6C-08-ED-81-EF-8B-59-6B-3B-45-24-8F-28-F1-62-DD
8F-E5-CC-4D-17-03-56-FC-58-6A-5E-00-A9-6E-DE-4D
30-28-32-E2-A6-6E-28-17-82-68-83-A5-B1-0C-6B-CF
8A-0D-BB-01-7D-38-0B-85-1C-91-EC-48-AC-03-2A-A8
93-5D-4F-1D-3F-37-4A-37-D0-14-6B-AF-8C-D3-17-9F
23-D8-46-77-88-70-D4-09-8F-05-5A-70-74-34-5C-4C
69-35-B4-A2-06-27-56-63-CB-8A-7D-AB-2B-7C-FC-AB
AC-B3-F6-C7-28-5D-FC-15-D0-B7-74-3C-D0-6B-20-0B
81-94-50-1F-D2-D7-23-F9-9F-B5-3E-2C-C6-F0-CF-57
B7-57-66-85-41-27-EB-0F-34-1A-3E-EE-F3-51-E6-A0
AB-86-E8-56-FB-B7-87-10-6B-A1-1E-3C-99-27-FD-B7
7D-CD-99-31-E0-90-AB-D3-DE-75-BA-2F-28-AC-D7-5F
66-FA-1D-5E-79-EF-78-AF-8D-77-79-6E-AF-FA-A8-54
B0-47-12-56-0B-08-35-DA-58-A2-CB-F6-59-C2-1A-F3
E6-0F-78-A8-C4-09-BD-8F-9E-79-17-A3-46-A8-76-97
77-DA-4E-20-5F-00-E8-62-C0-42-61-FA-D1-72-07-4A
52-09-4D-5B-70-BB-79-68-5F-25-EF-EF-F9-B8-8A-C3
96-EE-EC-08-42-9D-75-70-42-D6-47-15-2E-3B-E1-44
17-34-5F-E7-C2-F8-EE-04-EB-60-62-11-C6-3A-8C-0B
C5-4C-3B-79-51-33-BB-0C-84-09-F1-48-68-77-28-83
9B-A1-B7-4B-09-F0-A8-18-1C-80-C8-A5-9F-2A-A4-D7
DB-DA-39-AB-B4-A4-10-0B-A7-2A-F1-8D-58-E0-53-80
15-FD-4F-3E-86-D0-70-D2-10-AF-01-F5-5F-58-93-5D
55-F1-DD-DF-AF-82-CC-E1-F7-AE-07-CA-5E-F9-40-1B
FB-97-D2-98-96-F9-F0-C4-AF-CD-DE-B3-D1-9E-62-F0
BB-00-1C-61-E4-22-47-2D-E6-AF-52-CC-B3-AE-F4-98
4E-09-3C-81-F7-90-B2-19-04-74-F2-64-56-F8-7D-8D
72-8D-71-F6-A3-B1-07-BF-4E-2B-61-7F-9C-74-8A-32
93-DA-F1-2C-3E-A7-19-90-7C-C8-E8-75-B1-F7-AC-F2
D3-AB-0F-3E-C7-FC-FA-CE-1B-07-ED-74-D4-A7-CB-2D
20-C9-28-AE-3F-6D-F0-D1-2F-DB-95-83-72-0D-68-B0
00-74-89-8D-FD-AB-EB-DF-02-E9-37-85-96-4F-FF-AB
74-99-75-0F-AD-E5-C7-F9-8D-1C-8F-98-87-63-65-57
EE-FB-76-5A-9F-5C-07-04-43-FF-8E-BE-29-79-E8-64
6E-52-0D-48-B0-CB-1D-AD-8B-7A-68-8B-94-A3-81-7D
16-FF-2D-7E-FE-09-3A-85-D3-C6-6E-47-C0-AA-F5-A0
69-9D-03-B9-A1-2A-0F-07-0D-52-14-D2-BC-A5-CD-5A
CE-83-D1-D0-25-1F-0C-B9-46-87-41-D2-35-47-CE-16
6E-F1-63-50-FA-7B-C2-7C-73-EF-2B-61-17-DC-FD-2B
16-3C-00-10-99-E3-33-A0-2E-C6-5E-63-A9-20-39-1D
0D-E2-E6-D8-0C-2B-5A-C5-43-4E-DB-85-86-A8-8A-6A
2D-CF-28-A2-35-53-13-8E-B8-49-B6-B8-10-B7-6C-0E
DB-B7-94-47-30-76-FA-91-9D-4F-45-E5-7B-B7-54-A3
49-BD-5D-99-59-D2-93-6F-5E-E9-B9-0E-C8-71-A9-5F
49-A1-3A-0B-3F-2B-7D-9E-15-86-77-F9-70-F9-21-1A
08-75-26-67-33-F5-60-9B-2A-95-9C-50-C3-BF-5E-F4
69-BF-E7-83-CE-15-31-07-15-0C-EB-47-02-44-22-ED
DC-8D-41-09-C5-11-E1-FB-AB-F5-F2-FF-E0-0C-10-33
DA-D0-FF-E9-02-68-2A-45-88-FD-FB-42-47-9C-22-2F
B7-18-16-9D-83-F8-4A-64-54-80-F8-90-DA-26-19-BD
2E-08-CB-7E-A8-B8-F9-7C-BD-15-EB-B5-BC-23-8A-B1
A5-F8-B7-7A-F9-17-73-47-20-F3-0F-6F-2A-59-A4-31
27-93-C4-40-6C-7F-FE-66-08-ED-13-68-9C-24-DD-9E
5E-C4-11-AF-AF-6C-6F-60-F9-3E-EF-36-84-51-44-BA
3F-BF-38-2A-8C-8D-13-B6-67-46-94-83-99-8C-88-04
6B-9C-03-50-50-0A-59-5F-74-6A-AD-E5-B9-62-C4-79
0B-F8-15-7A-59-DB-2B-F5-5A-B9-23-7C-D1-48-41-32
27-E8-D6-FD-DC-34-8F-F8-54-CF-B4-65-0E-1E-FE-68
0B-E0-EF-D3-C6-94-33-C0-12-E7-E4-2B-07-5E-EF-DC
2C-90-CC-D5-46-5B-8F-AE-97-A9-5F-EB-21-DA-B1-BE
AB-44-C1-B9-BC-FC-1C-AB-41-C8-BE-02-23-22-55-E5
D6-02-82-09-95-33-16-0A-5F-2E-E1-15-9B-6F-38-08
6F-78-8E-E5-4E-0A-35-9C-1C-90-6A-A7-9A-59-9D-AA
A4-37-0D-25-6B-0D-FA-24-5E-6A-37-F0-96-CA-07-E1
71-4E-9E-3F-91-DA-6E-00-F8-CA-F1-46-8D-C7-44-28
66-74-28-84-53-A6-9C-C2-C7-7B-E0-05-3A-79-54-5E
D5-1F-49-63-F0-0D-08-67-AE-83-37-D3-BD-40-C2-63
4C-40-B4-4F-ED-E0-B3-F5-F4-89-66-62-CC-53-34-3C
3F-5E-F6-DA-C4-FC-5E-E7-6D-0B-7E-0F-4F-1A-5F-91
92-A6-A4-6D-0F-04-5B-A9-44-88-00-C0-90-36-98-04
EA-3B-0D-CA-43-5A-B7-C2-A7-71-67-A8-F6-CC-AD-DF
FC-98-8F-EB-F7-6D-7F-5A-DC-91-61-3B-AA-68-80-02
28-20-B9-D5-C7-88-EB-E8-CF-17-BC-5F-01-54-57-8B
B9-4A-A0-71-22-A2-E6-AD-A2-40-E2-F1-4A-AB-76-FF
4C-96-FB-9A-3F-32-2C-32-84-15-A7-3A-A9-89-4F-04
36-1F-84-08-BC-DB-AB-10-F6-68-98-A6-73-36-6A-51
91-9C-B6-B9-B8-7B-C9-B3-80-0A-EB-2B-B4-15-FB-2D
18-B4-16-61-E5-FE-16-A3-90-48-20-91-E3-BD-D7-01
98-7F-0C-5E-15-C8-06-BB-04-63-79-16-E4-89-35-9A
CA-10-05-12-82-F6-BA-FE-C6-A7-9F-46-B7-34-EE-5E
D3-F6-35-F1-5B-DD-67-D7-09-3D-54-B4-36-D0-E5-CE
AB-F4-3F-E9-4A-E3-5C-A9-68-2E-70-EA-13-0C-B9-F1
07-2D-93-59-EE-CE-3B-92-A1-E2-F1-D7-C2-A2-4D-58
1F-3A-77-2F-7D-98-C3-00-12-CD-48-0E-02-0A-A9-6A
6E-23-A5-F6-A3-9B-84-04-F0-EB-22-DD-19-4D-B8-F6
12-E5-A6-C3-A4-13-0B-D2-E3-4E-57-B6-FB-EB-F1-E5
8F-C0-E5-B0-76-DF-4F-4D-DE-47-69-2B-92-C0-86-6D
82-7A-5D-D4-DD-8A-BD-6F-A3-22-FD-F7-C8-4A-A7-2E
BC-CD-63-07-C9-64-E7-1A-48-B4-9C-DD-29-2C-C1-C3
3A-44-98-E3-06-DF-EF-59-86-53-0F-1C-74-95-ED-76
95-04-47-58-41-32-87-1F-F3-7A-FE-90-CE-46-4E-FA
A9-7A-F4-43-1B-0B-14-F7-94-CF-49-A7-66-59-DE-49
B3-18-5A-31-A9-00-11-50-21-62-A0-BB-E8-C2-A1-DE
B5-5A-B9-4C-1B-66-58-8B-9C-FD-32-EA-A0-50-98-17
41-02-67-E4-90-4E-03-E7-12-8E-DB-A6-91-92-C0-11
FE-F6-AE-A0-00-D3-DD-A4-48-A6-28-C1-CD-D3-E7-C1
FE-21-FA-6A-93-0D-1F-2E-9D-C8-97-A8-C2-FB-E9-9E
44-C7-70-15-9D-E8-F9-A5-8B-A6-A2-5D-D8-D0-D0-C0
F1-6B-4D-FD-5E-18-48-E5-E4-61-23-16-03-5F-A3-D2
AC-E4-07-68-0C-D9-CB-C2-B4-5B-92-27-3E-30-81-58
72-9E-E1-29-D5-F9-FA-EF-DD-31-2C-D1-62-1A-B1-8F
39-B7-C0-9B-76-6C-DA-2F-BB-09-92-86-6A-FB-D9-10
99-83-4A-82-FC-D7-B9-8D-72-00-E4-5D-44-D9-17-B2
BD-11-C0-54-4A-3E-A2-5E-87-06-BB-D3-4E-18-74-82
34-9C-15-EE-A6-63-08-58-FA-7C-61-BD-3A-7D-4C-B6
80-4B-4A-99-17-6B-BA-6F-FD-84-92-6C-9F-AF-E1-46
BF-C4-A6-A5-9B-3A-A7-9B-88-8C-EE-D2-EA-5D-B5-DE
76-C4-2A-3C-72-45-EE-6C-BE-57-8A-63-0F-1E-27-B6
2D-F3-73-34-06-E1-E9-9E-E1-85-36-5F-A9-61-F2-57
69-36-11-09-62-21-DB-86-99-9C-A1-D8-9F-E7-3B-50
79-94-CD-6E-C0-7C-1B-9F-AA-19-EA-B1-D6-79-F1-9D
44-BD-42-12-27-E4-4F-15-98-BD-37-04-F4-4F-D9-C2
95-07-BE-F2-BE-0A-B6-D0-9F-A6-B7-06-44-38-3A-75
EA-DD-7C-D1-D9-72-34-E9-69-90-38-44-9D-D5-EF-E9
DB-37-C8-E8-F1-9F-3A-82-75-F0-D5-21-B7-90-57-F6
CF-A8-8F-DE-7A-9D-BA-53-05-76-95-05-92-73-C5-F0
9E-F0-B6-41-F5-6C-F2-33-57-AA-7E-11-7E-98-9D-D9
A0-2A-70-4D-03-D8-C7-B4-A8-12-1A-8D-DF-09-8D-EE
19-A1-A4-1A-45-C5-A4-5B-B8-BA-5D-33-A2-E6-87-BD
0D-86-CA-0C-F8-17-67-CB-4D-D9-EB-E4-B1-0C-3C-1E
13-21-4A-D7-28-E2-FF-6A-F8-26-AA-3B-31-F8-52-82
B1-74-D8-98-7C-95-7D-A4-4B-52-0B-D7-A8-33-F7-6F
BB-F0-36-9E-55-25-69-61-C7-0B-F2-2C-5F-B9-59-E1
EF-0F-3E-B8-40-A8-3F-7D-85-45-93-53-66-F0-93-41
F9-8A-8B-24-E0-C1-30-4D-C4-5D-AF-DB-39-44-4D-7D
D6-A3-98-0D-6E-AA-D6-67-2F-EA-40-8F-0E-63-6D-A4
BF-64-CF-3F-FA-6E-D0-CD-46-46-49-B7-E7-F5-60-0F
A3-01-78-8B-2C-6A-1A-2F-98-4D-5E-8E-33-5B-1D-76
51-2E-B5-A6-0D-F5-EE-A8-21-D8-42-00-45-E7-D0-C5
2B-36-15-FE-86-0C-A5-EA-F5-C5-E8-BD-A5-25-92-CB
A2-0A-6F-F8-A1-C5-A7-5D-EC-6F-BE-A7-36-47-F6-87
3A-52-F1-0D-A8-6F-21-72-C2-22-09-22-27-74-7E-DA
7E-4C-DF-DC-6A-2B-D8-4B-DB-5E-FC-DD-8B-BA-EC-3D
00-8E-86-69-6C-AF-95-E8-30-81-3B-B9-6E-5D-34-B8
5E-F6-C7-1E-78-E5-66-B1-3F-1A-B7-5D-F2-6E-90-E7
DB-99-F2-7A-4A-36-CB-36-7C-9B-B1-0F-75-53-69-5A
EF-41-EF-3A-AD-63-FA-A2-28-13-2B-CC-D5-E9-FF-CC
6C-36-C5-E9-E1-EB-EA-DC-04-95-A1-68-23-8E-1C-B8
CE-30-20-DC-56-EA-73-46-32-E5-F3-A2-86-76-BB-80
1B-FD-76-71-06-7D-5C-27-3E-29-17-18-12-83-18-65
B2-10-1D-0E-76-B6-48-FC-B5-B9-BA-FB-F9-3F-C2-49
89-1C-C7-8A-F3-A7-46-A3-01-8D-35-A7-E6-A4-3D-51
7E-EE-8A-B2-B4-0D-08-14-4F-85-AA-2E-8D-8A-CA-53
5B-EC-00-09-BA-89-57-88-AB-48-4C-9E-87-0C-B1-02
CF-49-7D-73-79-E1-8A-92-44-E7-CE-6E-CD-CB-9B-02
5B-FD-E2-E5-92-91-25-74-24-23-CC-2E-E6-DD-A2-C5
68-2D-F7-F3-AA-8C-51-80-36-97-CC-BB-1C-17-6A-CC
80-B9-3E-C0-98-6A-CE-59-A4-77-95-CE-01-AB-23-BE
BB-A6-7C-5D-A7-0C-AE-5E-4B-02-03-51-B3-7D-E8-A8
D3-C9-FD-B9-FD-11-27-7E-57-BC-9F-2E-29-65-57-D4
C3-6C-B7-86-4E-67-F7-DA-7B-1E-88-6B-1F-F7-9B-11
29-94-38-54-33-F7-8D-A2-AA-83-76-9F-44-BA-97-F6
FB-30-09-11-02-99-F7-CD-27-19-4D-A1-AA-AF-F7-4D
2F-39-D1-8C-EE-D8-31-42-46-EB-4D-69-61-B1-36-56
DB-1B-2E-56-D9-15-A8-9A-57-91-97-B0-44-58-ED-C6
E7-86-C2-C5-5A-E9-8C-FC-BA-B9-85-AF-BE-47-23-C1
CD-7F-92-10-77-F1-BB-41-F1-95-29-9B-51-5F-E7-24
E4-69-0F-1C-D3-E8-E7-E4-58-22-9F-9D-05-C2-9A-34
2A-1E-57-57-95-99-46-92-51-AC-C0-9D-A2-F5-41-5A
53-04-31-97-3A-AC-1F-32-0E-AD-32-C1-9D-F8-F1-37
15-B0-1C-3B-41-B1-80-F1-ED-7A-90-56-13-B8-15-83
77-EA-D1-83-81-EC-8A-70-69-49-AB-BA-A1-30-A2-B8
35-1F-A0-20-85-6D-5D-D2-85-7D-3F-9E-F7-C4-E6-13
7D-6D-E3-02-0D-60-31-25-35-63-1C-14-97-7E-2E-DB
24-BA-53-20-35-C2-88-17-70-60-ED-95-75-77-57-78
C5-1B-58-A1-EC-3B-D1-7C-78-FB-2A-FB-A5-E7-B6-53
38-58-10-BD-B2-31-19-AC-91-91-EF-DB-6C-04-F9-32
54-3D-55-D2-05-E0-D1-A5-D2-49-6D-22-FB-9F-A6-C1
64-36-2C-07-2F-46-07-D1-BD-B3-4F-4D-C0-A3-22-B6
9E-EB-94-2D-75-68-37-28-EC-FC-57-41-12-AE-AB-D1
AB-B3-7A-04-07-6C-7E-DE-8D-DB-44-03-47-15-A9-85
E9-BD-70-4B-81-8D-FC-F3-55-CB-52-63-01-D3-5C-9E
FF-0E-0C-A1-88-EB-1C-53-53-C4-B0-7E-B8-16-3F-ED
99-33-2C-F9-75-B0-04-A1-F4-63-9E-22-3D-74-23-FE
5E-A3-5D-27-9D-CC-1A-B7-9F-FF-DD-22-7E-DC-DA-CE
57-B3-8E-2D-30-9B-01-EA-53-8E-B6-B2-83-D3-83-70
A4-B2-B5-4E-42-BB-A9-24-6C-FD-7B-7B-EB-E6-DE-94
D8-7C-96-9C-94-8E-8A-F4-B0-D8-41-0B-29-B3-ED-08
E1-37-3B-09-EB-EC-BC-B3-92-62-05-5B-B9-6C-68-FD
3E-05-42-D6-13-4C-73-CB-96-4B-0A-6F-14-02-6A-64
44-A0-53-1C-22-66-1F-15-40-78-74-B6-49-7E-47-52
D2-4A-2C-7E-C5-F9-77-C0-E6-0D-1E-13-E4-5F-9D-F2
AC-FB-5F-32-BE-0B-A5-DC-8C-47-E0-53-63-E8-0F-6E
A2-C1-ED-BE-08-3B-6E-EA-99-65-90-27-9F-ED-84-3A
4E-34-D5-21-04-43-9B-54-2A-B4-2A-04-90-E3-D2-89
11-8F-3F-F8-55-B4-46-4A-12-26-42-2A-C1-B4-58-A5
51-03-04-AA-D3-AD-05-27-7D-B5-20-2A-D4-8A-A3-28
EB-B2-49-F3-3A-AF-F0-3A-9B-89-27-C9-E1-CE-8D-6E
A0-09-4C-1F-31-98-9E-ED-01-B9-43-15-C1-EF-5F-F3
B4-30-D8-8A-48-D6-E9-ED-A6-19-F8-BE-FD-D9-A8-C3
A3-16-A0-8A-2D-6B-FC-12-F9-E8-7D-CB-9F-A8-31-91
E7-F4-66-E4-9B-4F-D4-A6-4A-A2-26-E2-65-93-E2-4E
CB-DB-49-C3-53-85-7F-DE-6D-DD-87-A9-E4-09-FE-ED
D5-A5-54-31-DD-EB-68-C1-E2-5E-7D-90-EA-B2-19-6E
55-E4-DF-21-AB-07-17-13-EC-68-CD-B9-32-F2-CD-BC
88-62-DE-BF-E0-7D-AA-BD-C2-2D-1F-08-FC-23-52-DF
BB-78-B4-7E-16-70-E0-61-30-F6-41-33-A4-5A-2F-4F
6F-0D-97-70-AF-6B-69-ED-5B-7D-C9-2E-1B-0C-6E-7C
91-2A-F7-CD-F4-1A-4E-49-38-80-64-FB-91-18-87-FA
4C-8B-AF-F0-2B-D5-D1-BD-A8-64-99-86-58-ED-CB-9F
4E-85-D8-CD-6A-E3-AA-87-05-96-40-D2-7A-7A-6D-B8
06-24-F6-5E-51-F1-0A-9A-25-59-A5-F7-8A-7D-EE-F5
76-30-85-43-F1-C1-8F-30-67-84-2C-6D-56-57-29-31
34-D0-63-E0-17-DF-45-68-D0-BB-5C-6C-F3-23-69-BF
B2-0F-4E-64-89-4C-1F-5D-F4-AD-AF-80-B9-C8-CE-0A
7E-E7-BA-EC-10-6E-B1-22-EC-A9-84-0B-55-F7-B1-1A
B5-76-70-53-D8-09-6B-46-DD-B3-E0-9C-52-81-5C-BA
8B-3C-F3-5B-00-13-A2-46-66-98-89-AA-88-63-2E-85
19-21-E7-F9-15-CC-B4-82-C9-21-83-34-FD-F4-05-20
